3002021	HOUSE_NO	HOUSE_NO
lougheed	STREET_NAME	STREET_NAME

1803775	HOUSE_NO	HOUSE_NO
202	STREET_NAME	STREET_NAME
se	STREET_NAME	STREET_NAME

015930	HOUSE_NO	HOUSE_NO
old	STREET_NAME	STREET_NAME
simcoe	STREET_NAME	STREET_NAME

11o14800	HOUSE_NO	HOUSE_NO
yonge	STREET_NAME	STREET_NAME

0513	HOUSE_NO	HOUSE_NO
division	STREET_NAME	STREET_NAME

0511	HOUSE_NO	HOUSE_NO
maple	STREET_NAME	STREET_NAME
grove	STREET_NAME	STREET_NAME

04196	HOUSE_NO	HOUSE_NO
dawson	STREET_NAME	STREET_NAME

3791450	HOUSE_NO	HOUSE_NO
hillside	STREET_NAME	STREET_NAME

715	HOUSE_NO	HOUSE_NO
ringwood	STREET_NAME	STREET_NAME

14380	HOUSE_NO	HOUSE_NO
south	STREET_NAME	STREET_NAME
service	STREET_NAME	STREET_NAME

a3185	HOUSE_NO	HOUSE_NO
king	STREET_NAME	STREET_NAME
george	STREET_NAME	STREET_NAME

0644	HOUSE_NO	HOUSE_NO
portland	STREET_NAME	STREET_NAME

6	HOUSE_NO	HOUSE_NO
pauls	STREET_NAME	STREET_NAME
parade	STREET_NAME	STREET_NAME
apartment	SUITE_NO	SUITE_NO
1	SUITE_NO	SUITE_NO

90	HOUSE_NO	HOUSE_NO
henderson	STREET_NAME	STREET_NAME
eet	STREET_NAME	STREET_NAME
apartment	SUITE_NO	SUITE_NO
a	SUITE_NO	SUITE_NO

165	HOUSE_NO	HOUSE_NO
granville	STREET_NAME	STREET_NAME
eet	STREET_NAME	STREET_NAME
apartment	SUITE_NO	SUITE_NO
1	SUITE_NO	SUITE_NO

29	HOUSE_NO	HOUSE_NO
zetland	STREET_NAME	STREET_NAME
eet	STREET_NAME	STREET_NAME
apartment	SUITE_NO	SUITE_NO
1	SUITE_NO	SUITE_NO

42	HOUSE_NO	HOUSE_NO
crouch	STREET_NAME	STREET_NAME
eet	STREET_NAME	STREET_NAME
apartment	STREET_NAME	SUITE_NO
2	SUITE_NO	SUITE_NO

5	HOUSE_NO	HOUSE_NO
green	STREET_NAME	STREET_NAME
road	STREET_NAME	STREET_NAME
unit	SUITE_NO	STREET_NAME
2	SUITE_NO	SUITE_NO

29	HOUSE_NO	HOUSE_NO
wellington	STREET_NAME	STREET_NAME
eet	STREET_NAME	STREET_NAME
12	SUITE_NO	HOUSE_NO

92	HOUSE_NO	HOUSE_NO
burton	STREET_NAME	STREET_NAME
3	SUITE_NO	HOUSE_NO

160	HOUSE_NO	HOUSE_NO
new	STREET_NAME	STREET_NAME
eet	STREET_NAME	STREET_NAME
4	SUITE_NO	HOUSE_NO

213	HOUSE_NO	HOUSE_NO
station	STREET_NAME	STREET_NAME
1	SUITE_NO	SUITE_NO

c	SUITE_NO	STREET_NAME
6	HOUSE_NO	HOUSE_NO
henderson	STREET_NAME	STREET_NAME
place	STREET_NAME	STREET_NAME
onehunga	STREET_NAME	SUITE_NO

2045	HOUSE_NO	HOUSE_NO
collins	STREET_NAME	STREET_NAME
eet	STREET_NAME	STREET_NAME

150	HOUSE_NO	HOUSE_NO
abernethy	STREET_NAME	STREET_NAME

12	HOUSE_NO	HOUSE_NO
d'auxerre	STREET_NAME	STREET_NAME
89	SUITE_NO	SUITE_NO

3	HOUSE_NO	HOUSE_NO
de	STREET_NAME	STREET_NAME
cluny	STREET_NAME	STREET_NAME
71	SUITE_NO	SUITE_NO

2	HOUSE_NO	HOUSE_NO
de	STREET_NAME	STREET_NAME
carentan	STREET_NAME	STREET_NAME
50	SUITE_NO	SUITE_NO

100	HOUSE_NO	HOUSE_NO
witherwood	STREET_NAME	STREET_NAME
212	SUITE_NO	HOUSE_NO

4748	HOUSE_NO	HOUSE_NO
s	STREET_NAME	STREET_NAME
highland	STREET_NAME	STREET_NAME

701	HOUSE_NO	HOUSE_NO
us	STREET_NAME	STREET_NAME
52	STREET_NAME	HOUSE_NO
north	STREET_NAME	STREET_NAME

15	HOUSE_NO	HOUSE_NO
event	STREET_NAME	STREET_NAME
center	STREET_NAME	STREET_NAME
way	STREET_NAME	STREET_NAME

5151	HOUSE_NO	HOUSE_NO
citrus	STREET_NAME	STREET_NAME

1016	HOUSE_NO	HOUSE_NO
main	STREET_NAME	STREET_NAME

200	HOUSE_NO	HOUSE_NO
main	STREET_NAME	STREET_NAME
e	STREET_NAME	STREET_NAME

5051	HOUSE_NO	HOUSE_NO
s	STREET_NAME	STREET_NAME
27th	STREET_NAME	STREET_NAME

319	HOUSE_NO	HOUSE_NO
3rd	STREET_NAME	STREET_NAME

78	HOUSE_NO	HOUSE_NO
공단1	STREET_NAME	STREET_NAME
로	STREET_NAME	STREET_NAME

10	HOUSE_NO	HOUSE_NO
테헤란로1	STREET_NAME	STREET_NAME
길	STREET_NAME	STREET_NAME
역삼동	STREET_NAME	STREET_NAME

53	HOUSE_NO	HOUSE_NO
비둘기공원7	STREET_NAME	STREET_NAME
길	STREET_NAME	STREET_NAME
대야동	STREET_NAME	STREET_NAME

112	HOUSE_NO	HOUSE_NO
수장	STREET_NAME	STREET_NAME
로	STREET_NAME	STREET_NAME

270	HOUSE_NO	HOUSE_NO
만삼	STREET_NAME	STREET_NAME
로	STREET_NAME	STREET_NAME

1001	HOUSE_NO	HOUSE_NO
w	STREET_NAME	STREET_NAME
19th	STREET_NAME	STREET_NAME
d	STREET_NAME	STREET_NAME

6419	HOUSE_NO	HOUSE_NO
w	STREET_NAME	STREET_NAME
newberry	STREET_NAME	STREET_NAME
g8	SUITE_NO	STREET_NAME

5890	HOUSE_NO	HOUSE_NO
kingstowne	STREET_NAME	STREET_NAME
center	STREET_NAME	STREET_NAME
100	SUITE_NO	SUITE_NO

500	HOUSE_NO	HOUSE_NO
bagby	STREET_NAME	STREET_NAME
c	STREET_NAME	STREET_NAME

23119	HOUSE_NO	HOUSE_NO
colonial	STREET_NAME	STREET_NAME
a14	SUITE_NO	STREET_NAME

4d744	HOUSE_NO	HOUSE_NO

276	SUITE_NO	HOUSE_NO

649	HOUSE_NO	HOUSE_NO
h	STREET_NAME	STREET_NAME
315	SUITE_NO	HOUSE_NO

37370	HOUSE_NO	HOUSE_NO
birch	STREET_NAME	STREET_NAME
a	SUITE_NO	SUITE_NO

50	SUITE_NO	HOUSE_NO
arena	STREET_NAME	STREET_NAME

3220	SUITE_NO	HOUSE_NO
acton	STREET_NAME	STREET_NAME

408	HOUSE_NO	HOUSE_NO
n	STREET_NAME	STREET_NAME
path	STREET_NAME	STREET_NAME
408	SUITE_NO	HOUSE_NO

201	HOUSE_NO	HOUSE_NO
calle	STREET_NAME	STREET_NAME
isla	STREET_NAME	STREET_NAME
path	STREET_NAME	STREET_NAME
17a	SUITE_NO	SUITE_NO

315	HOUSE_NO	HOUSE_NO
h	STREET_NAME	STREET_NAME
649	SUITE_NO	HOUSE_NO

viaduct	STREET_NAME	STREET_NAME
torino	STREET_NAME	STREET_NAME
219	HOUSE_NO	SUITE_NO

ada	STREET_NAME	STREET_NAME
rozelor	STREET_NAME	STREET_NAME
2	SUITE_NO	HOUSE_NO

calle	STREET_NAME	STREET_NAME
victoria	STREET_NAME	STREET_NAME
1	HOUSE_NO	SUITE_NO

calle	STREET_NAME	STREET_NAME
felipe	STREET_NAME	STREET_NAME
asenjo	STREET_NAME	STREET_NAME
20	HOUSE_NO	SUITE_NO

kühns	STREET_NAME	STREET_NAME
3	HOUSE_NO	HOUSE_NO

żelazna	STREET_NAME	STREET_NAME
53	HOUSE_NO	HOUSE_NO

rua	STREET_NAME	STREET_NAME
primeiro	STREET_NAME	STREET_NAME
de	STREET_NAME	STREET_NAME
marã§o	STREET_NAME	STREET_NAME
123	HOUSE_NO	SUITE_NO

al	STREET_NAME	STREET_NAME
spółdzielczości	STREET_NAME	STREET_NAME
pracy	STREET_NAME	STREET_NAME
32	HOUSE_NO	HOUSE_NO

lübecker	STREET_NAME	STREET_NAME
2	HOUSE_NO	HOUSE_NO

茨城県	STREET_NAME	STREET_NAME
桜の郷	STREET_NAME	STREET_NAME
３３４４	HOUSE_NO	STREET_NAME
２	HOUSE_NO	HOUSE_NO

成業街	STREET_NAME	STREET_NAME
7	HOUSE_NO	HOUSE_NO

hohenzollernaãÿe	STREET_NAME	STREET_NAME
311	HOUSE_NO	HOUSE_NO

ziegeleiaãÿe	STREET_NAME	STREET_NAME
1721	HOUSE_NO	HOUSE_NO

kastanienallee	STREET_NAME	STREET_NAME
911	HOUSE_NO	HOUSE_NO

fatih	STREET_NAME	STREET_NAME
caddesi	STREET_NAME	STREET_NAME
1113	HOUSE_NO	HOUSE_NO

viaduct	STREET_NAME	STREET_NAME
vecchia	STREET_NAME	STREET_NAME
casilina	STREET_NAME	STREET_NAME
90200	HOUSE_NO	HOUSE_NO

wernerreimersaãÿe	STREET_NAME	STREET_NAME
24	HOUSE_NO	HOUSE_NO

152024	HOUSE_NO	HOUSE_NO
castlereagh	STREET_NAME	STREET_NAME
eet	STREET_NAME	STREET_NAME

g37143720	HOUSE_NO	HOUSE_NO
mount	STREET_NAME	STREET_NAME
lindesay	STREET_NAME	STREET_NAME

23050	HOUSE_NO	HOUSE_NO
warrego	STREET_NAME	STREET_NAME

2042191201	HOUSE_NO	HOUSE_NO
pitt	STREET_NAME	STREET_NAME
eet	STREET_NAME	STREET_NAME

t05200204	HOUSE_NO	HOUSE_NO
murray	STREET_NAME	STREET_NAME
eet	STREET_NAME	STREET_NAME

6118120	HOUSE_NO	HOUSE_NO
Edwards	STREET_NAME	STREET_NAME
eet	STREET_NAME	STREET_NAME

16	SUITE_NO	HOUSE_NO
1620	HOUSE_NO	STREET_NAME
fort	STREET_NAME	STREET_NAME
eet	STREET_NAME	STREET_NAME

drake	STREET_NAME	STREET_NAME
355	HOUSE_NO	HOUSE_NO

watkins	STREET_NAME	STREET_NAME
springs	STREET_NAME	STREET_NAME
526	HOUSE_NO	HOUSE_NO

club	STREET_NAME	STREET_NAME
03254	HOUSE_NO	HOUSE_NO

miller	STREET_NAME	STREET_NAME
oval	STREET_NAME	STREET_NAME
63431	HOUSE_NO	HOUSE_NO

green	STREET_NAME	STREET_NAME
bypass	STREET_NAME	STREET_NAME
88866	HOUSE_NO	HOUSE_NO

veronica	STREET_NAME	STREET_NAME
rapid	STREET_NAME	STREET_NAME
769	HOUSE_NO	HOUSE_NO

sierra	STREET_NAME	STREET_NAME
gateway	STREET_NAME	STREET_NAME
32547	HOUSE_NO	HOUSE_NO

william	STREET_NAME	STREET_NAME
tunnel	STREET_NAME	STREET_NAME
83833	HOUSE_NO	HOUSE_NO

morales	STREET_NAME	STREET_NAME
13265	HOUSE_NO	HOUSE_NO

nelson	STREET_NAME	STREET_NAME
harbor	STREET_NAME	STREET_NAME
8392	HOUSE_NO	HOUSE_NO

anderson	STREET_NAME	STREET_NAME
glens	STREET_NAME	STREET_NAME
113	HOUSE_NO	HOUSE_NO

pacheco	STREET_NAME	STREET_NAME
617	HOUSE_NO	HOUSE_NO

melissa	STREET_NAME	STREET_NAME
islands	STREET_NAME	STREET_NAME
85841	HOUSE_NO	HOUSE_NO

katherine	STREET_NAME	STREET_NAME
throughway	STREET_NAME	STREET_NAME
80682	HOUSE_NO	HOUSE_NO

randall	STREET_NAME	STREET_NAME
club	STREET_NAME	STREET_NAME
07429	HOUSE_NO	HOUSE_NO

laurie	STREET_NAME	STREET_NAME
centers	STREET_NAME	STREET_NAME
0627	HOUSE_NO	HOUSE_NO

steven	STREET_NAME	STREET_NAME
parkways	STREET_NAME	STREET_NAME
1395	HOUSE_NO	HOUSE_NO

guzman	STREET_NAME	STREET_NAME
neck	STREET_NAME	STREET_NAME
5243	HOUSE_NO	HOUSE_NO

harvey	STREET_NAME	STREET_NAME
canyon	STREET_NAME	STREET_NAME
2329	HOUSE_NO	HOUSE_NO

wilkinson	STREET_NAME	STREET_NAME
extensions	STREET_NAME	STREET_NAME
721	HOUSE_NO	HOUSE_NO

sullivan	STREET_NAME	STREET_NAME
mountain	STREET_NAME	STREET_NAME
163	HOUSE_NO	HOUSE_NO

olson	STREET_NAME	STREET_NAME
18145	HOUSE_NO	HOUSE_NO

randy	STREET_NAME	STREET_NAME
village	STREET_NAME	STREET_NAME
976	HOUSE_NO	HOUSE_NO

turner	STREET_NAME	STREET_NAME
ranch	STREET_NAME	STREET_NAME
6374	HOUSE_NO	HOUSE_NO

wells	STREET_NAME	STREET_NAME
lodge	STREET_NAME	STREET_NAME
828	HOUSE_NO	HOUSE_NO

larry	STREET_NAME	STREET_NAME
forks	STREET_NAME	STREET_NAME
448	HOUSE_NO	HOUSE_NO

lewis	STREET_NAME	STREET_NAME
tunnel	STREET_NAME	STREET_NAME
4386	HOUSE_NO	HOUSE_NO

weiss	STREET_NAME	STREET_NAME
greens	STREET_NAME	STREET_NAME
739	HOUSE_NO	HOUSE_NO

joel	STREET_NAME	STREET_NAME
glens	STREET_NAME	STREET_NAME
059	HOUSE_NO	HOUSE_NO

lin	STREET_NAME	STREET_NAME
passage	STREET_NAME	STREET_NAME
457	HOUSE_NO	HOUSE_NO

crawford	STREET_NAME	STREET_NAME
orchard	STREET_NAME	STREET_NAME
94588	HOUSE_NO	HOUSE_NO

hunter	STREET_NAME	STREET_NAME
locks	STREET_NAME	STREET_NAME
98787	HOUSE_NO	HOUSE_NO

williams	STREET_NAME	STREET_NAME
4840	HOUSE_NO	HOUSE_NO

nathaniel	STREET_NAME	STREET_NAME
forks	STREET_NAME	STREET_NAME
61905	HOUSE_NO	HOUSE_NO

miller	STREET_NAME	STREET_NAME
lodge	STREET_NAME	STREET_NAME
5077	HOUSE_NO	HOUSE_NO

case	STREET_NAME	STREET_NAME
cliffs	STREET_NAME	STREET_NAME
60975	HOUSE_NO	HOUSE_NO

jimenez	STREET_NAME	STREET_NAME
burgs	STREET_NAME	STREET_NAME
15649	HOUSE_NO	HOUSE_NO

walker	STREET_NAME	STREET_NAME
meadow	STREET_NAME	STREET_NAME
6861	HOUSE_NO	HOUSE_NO

brown	STREET_NAME	STREET_NAME
cape	STREET_NAME	STREET_NAME
9514	HOUSE_NO	HOUSE_NO

catherine	STREET_NAME	STREET_NAME
throughway	STREET_NAME	STREET_NAME
820	HOUSE_NO	HOUSE_NO

mary	STREET_NAME	STREET_NAME
park	STREET_NAME	STREET_NAME
866	HOUSE_NO	HOUSE_NO

king	STREET_NAME	STREET_NAME
islands	STREET_NAME	STREET_NAME
3805	HOUSE_NO	HOUSE_NO

jamie	STREET_NAME	STREET_NAME
477	HOUSE_NO	HOUSE_NO

henderson	STREET_NAME	STREET_NAME
heights	STREET_NAME	STREET_NAME
073	HOUSE_NO	HOUSE_NO

white	STREET_NAME	STREET_NAME
1620	HOUSE_NO	HOUSE_NO

michael	STREET_NAME	STREET_NAME
fort	STREET_NAME	STREET_NAME
1886	HOUSE_NO	HOUSE_NO

snow	STREET_NAME	STREET_NAME
villages	STREET_NAME	STREET_NAME
554	HOUSE_NO	HOUSE_NO

derek	STREET_NAME	STREET_NAME
glens	STREET_NAME	STREET_NAME
4061	HOUSE_NO	HOUSE_NO

michael	STREET_NAME	STREET_NAME
meadow	STREET_NAME	STREET_NAME
473	HOUSE_NO	HOUSE_NO

john	STREET_NAME	STREET_NAME
views	STREET_NAME	STREET_NAME
915	HOUSE_NO	HOUSE_NO

heidi	STREET_NAME	STREET_NAME
overpass	STREET_NAME	STREET_NAME
1255	HOUSE_NO	HOUSE_NO

richard	STREET_NAME	STREET_NAME
key	STREET_NAME	STREET_NAME
69546	HOUSE_NO	HOUSE_NO

richard	STREET_NAME	STREET_NAME
mission	STREET_NAME	STREET_NAME
507	HOUSE_NO	HOUSE_NO

robert	STREET_NAME	STREET_NAME
creek	STREET_NAME	STREET_NAME
89602	HOUSE_NO	HOUSE_NO

decker	STREET_NAME	STREET_NAME
summit	STREET_NAME	STREET_NAME
84020	HOUSE_NO	HOUSE_NO

lori	STREET_NAME	STREET_NAME
eets	STREET_NAME	STREET_NAME
1670	HOUSE_NO	HOUSE_NO

nelson	STREET_NAME	STREET_NAME
locks	STREET_NAME	STREET_NAME
433	HOUSE_NO	HOUSE_NO

jared	STREET_NAME	STREET_NAME
dam	STREET_NAME	STREET_NAME
15677	HOUSE_NO	HOUSE_NO

jennifer	STREET_NAME	STREET_NAME
prairie	STREET_NAME	STREET_NAME
4238	HOUSE_NO	HOUSE_NO

wood	STREET_NAME	STREET_NAME
eam	STREET_NAME	STREET_NAME
05830	HOUSE_NO	HOUSE_NO

lewis	STREET_NAME	STREET_NAME
lodge	STREET_NAME	STREET_NAME
5930	HOUSE_NO	HOUSE_NO

stafford	STREET_NAME	STREET_NAME
pine	STREET_NAME	STREET_NAME
52576	HOUSE_NO	HOUSE_NO

colton	STREET_NAME	STREET_NAME
knolls	STREET_NAME	STREET_NAME
31226	HOUSE_NO	HOUSE_NO

philip	STREET_NAME	STREET_NAME
islands	STREET_NAME	STREET_NAME
984	HOUSE_NO	HOUSE_NO

brian	STREET_NAME	STREET_NAME
unions	STREET_NAME	STREET_NAME
41859	HOUSE_NO	HOUSE_NO

roberson	STREET_NAME	STREET_NAME
points	STREET_NAME	STREET_NAME
023	HOUSE_NO	HOUSE_NO

daniels	STREET_NAME	STREET_NAME
5791	HOUSE_NO	HOUSE_NO

anthony	STREET_NAME	STREET_NAME
well	STREET_NAME	STREET_NAME
9567	HOUSE_NO	HOUSE_NO

justin	STREET_NAME	STREET_NAME
ramp	STREET_NAME	STREET_NAME
612	HOUSE_NO	HOUSE_NO

jason	STREET_NAME	STREET_NAME
86344	HOUSE_NO	HOUSE_NO

vazquez	STREET_NAME	STREET_NAME
extensions	STREET_NAME	STREET_NAME
2126	HOUSE_NO	HOUSE_NO

saunders	STREET_NAME	STREET_NAME
locks	STREET_NAME	STREET_NAME
000	HOUSE_NO	HOUSE_NO

beth	STREET_NAME	STREET_NAME
passage	STREET_NAME	STREET_NAME
779	HOUSE_NO	HOUSE_NO

jason	STREET_NAME	STREET_NAME
point	STREET_NAME	STREET_NAME
06045	HOUSE_NO	HOUSE_NO

jimenez	STREET_NAME	STREET_NAME
summit	STREET_NAME	STREET_NAME
201	HOUSE_NO	SUITE_NO

romero	STREET_NAME	STREET_NAME
673	HOUSE_NO	HOUSE_NO

olson	STREET_NAME	STREET_NAME
mall	STREET_NAME	STREET_NAME
2693	HOUSE_NO	HOUSE_NO

patterson	STREET_NAME	STREET_NAME
walk	STREET_NAME	STREET_NAME
151	HOUSE_NO	HOUSE_NO

jason	STREET_NAME	STREET_NAME
dale	STREET_NAME	STREET_NAME
7099	HOUSE_NO	HOUSE_NO

reyes	STREET_NAME	STREET_NAME
18651	HOUSE_NO	HOUSE_NO

